################# ##############
#******************************#
#******************************#
#*************@*********@******#
#***************<**************#
#******************************#
 **************#***************
#*************###**************#
#***************#********O*****#
#***************#**************#
#***************#**************#
#****############**************#
#******************************#
################# ##############
